1 1
1111111111111111111111111111
1000000000003000000000000001
1010010111111111111110101101
1010010100000000000010100101
1011110100000000111110100101
1000000000003000000000100121
1111111111111111111111111111
