1 1
1111111111111111111111111111
1022222222222112222222222221
1211112111112112111112111121
1211112111112112111112111121
1211112111112112111112111121
1222222222222222222222222221
1211112112111111112112111121
1211112112111111112112111121
1222222112222112222112222221
1111112111112112111112111111
1111112111112112111112111111
1111112112222222222112111111
1111112112111221112112111111
1111112112122222212112111111
1111112222102222212222111111
1111112112130222212112111111
1111112112111221112112111111
1111112112222222222112111111
1111112112111111112112111111
1111112112111111112112111111
1222222222222112222222222221
1211112111112112111112111121
1211112111112112111112111121
1222112222222222222222112221
1112112112111111112112112111
1112112112111111112112112111
1222222112222112222112030221
1211111111112112111111111121
1211111111112112111111111101
1222222222222222222222222031
1111111111111111111111111111
