1 1
1111111111111111111111111111
1022222222232222222222222221
1212212111111111111112121121
1212212122222222222212122121
1211112122232222111112122121
1222222222222222222222222221
1111111111111111111111111111
