1 1
1111111111111111111111111111
1000000000000000000000000001
1000000000000000000000000001
1000000000000000000000000001
1000000000000000000000000001
1000000000000000000000000001
1000022000000000002000000001
1000200200000000020000000001
1000200200000000202000000001
1000022000000000222000000001
1000000000000000000000000001
1000000000000000000000000001
1000000000000000002222000001
1000000000000000000020000001
1000000022000000000200000001
1000000200200000002000000001
1000000200200000000000000001
1000000022000000000000000001
1000000000000000000000000001
1000000000000000000000000001
1000000000000002000000000001
1000000000000022000000000001
1000000000000202000000000001
1000000000000002000000000001
1000000000000000000000000001
1000000222000222000000000001
1000002000002000000000000001
1000002000002000000000000001
1000000222000222000000000001
1000000000000000000000000001
1111111111111111111111111111
