1 1
1111111111111111111111111111
1222222222222222222222222221
1222222222222222222222222221
1222222222222222222222222221
1222222222222222222222222221
1222222222222222222222222221
1222222222222222222222222221
1222222222222222222222222221
1222222222222222222222222221
1222222222222222222222222221
1222222222222222222222222221
1222222222222222222222222221
1222222222222222222222222221
1222222222222222222222222221
1222222222222222222222222221
1222222222222222222222222221
1222222222222222222222222221
1222222222222222222222222221
1222222222222222222222222221
1222222222222222222222222221
1222222222222222222222222221
1222222222222222222222222221
1222222222222222222222222221
1222222222222222222222222221
1222222222222222222222222221
1222222222222222222222222221
1222222222222222222222222221
1222222222222222222222222221
1222222222222222222222222221
1222222222222222222222222231
1111111111111111111111111111