1 1
1111111111111111111111111111
1222222222222112222222222221
1211112111112112111112111121
1211112111112112111112111121
1211112111112110111112111121
1222222222222200300222222221
1211112112111111112112111121
1211112112111111112112111121
1222222112222112222112222221
1111110111112112111112111111
1111110111112112111112111111
1111113112222222222112111111
1111110112111111112112111111
1111110112100000012112111111
1111112222100000012222111111
1111112112100000012112111111
1111112112111111112112111111
1111112112222222222112111111
1111110112111111112112111111
1111110112111111112112111111
1222003002222112222222222221
1211110111112112111112111121
1211110111112112111112111121
1222112222222222222222112221
1112112112111111112112112111
1112112112111111112112112111
1222222112222112222112222221
1211111111112112111111111121
1211111111112112111111111121
1222222222222222222222222221
1111111111111111111111111111
